........##
..#..#.#.##
.....###...
#######...#
#......#..#
###..###..#
..#..#@...#
.##.##.#.##
.####....##
.#..#.#.##
.#######
